3
3 3
###
#.#
###
7 6
#######
#.#.###
#.#.###
#.#.#.#
#.....#
#######
8 5
########
...#.#.#
#.##.#.#
#.##.#.#
####.###
